*********************
*                   *
*   P               *
*       ***         *
*       ***         *
*       ***         *
*       ***         *
****          ***** *
*                  G*
*********************
