****************
*P             *
*              *
*              *
*   M          *
*              *
*              *
****           *
*             G*
****************
