****************
*P             *
*              *
*              *
*   M          *
****     M     *
*              *
*           ****
*             G*
****************
